a a a a a a a a a a a a a a a a a a a a a a a a a
a . . . . . . . . . . . . . . . . . . . . . . . a 
a . . . b b b b b b . . . . . . . . . . s . . . a 
a . . . . . . . . b b b b b b b b . . . . . . . a 
a . . . . . . . . . . . . . . . . b b b b b b . a 
a . . . . s . . . . . . . . . . . . . . . . . . a 
a . . . . . . . . . . . . . . . . . . . . . . . a 
a . . . . . . . . . . . . . . . . . . . . . . . a 
a . . . . . . . . . . . . . . . . . . . . . . . a 
a . . . . . . . . . . . . . . . . . . . . . . . a 
a . . . . . . . . . . . . . . . . . . . . . . . a 
a . . . . . . . . . . p . . . . . . . . . . . . a 
a . . . . . . . . . . . . . . . . . . . . . . . a 
a . . . . . . . . . . . . . . . . . . . . . . . a 
a . . . . . . . . . b b b b b b . . . . . . . . a 
a . . . . . . . . . . . . . . . . . . . . . . . a 
a . . . . . . . . . . . . . . . . . . . . . . . a 
a . . . . . . . . . . . . . . . . . . . . . . . a 
a . . . s . . . . b . . . . . . . . . . . . . . a 
a . . . . . . . . b . . . . . . . . . . . . . . a 
a . . . . . . . . b . . . . . . b b b b . . . . a 
a . . . . . . b b b . . . . . . b . . . . . . . a 
a . . . . . . . . . . . . . . . b . . s . . . . a 
a . . . . . . . . . . . . . . . . . . . . . . . a 
a a a a a a a a a a a a a a a a a a a a a a a a a